#########################
#          #            #
# ######## ########## # #
#        #            # #
##### ###### ## ### # # #
#   #         # #   ### #
# # ### ########### #   #
# # # # #     #   # # # #
# # # # ### # # ### # # #
# # #   # # # #   # ### #
# # ### # # # ### # #   #
# #   # #   #         ###
# ##### ######### ###   #
# #         #     #   # #
# # ####### # ##### # # #
#    #    #   #  #  # # #
# #### ## # # ## # ## # #
# #  #  #   #  # ###  # #
# ## ## # ######     ## #
#     # # #    # ###  # #
# ##### # # ##     ## # #
#  #    # #  # ### #  # #
# ####### #### # # #### #
#              #   #    #
#########################